                                                                                                                                                                                                                                                                                                                                                                                                                                  .
                             ...                           _                                              ...                           _                                                                     ...                           _                                                         ..                            _                   /|          |>>>                                              |>>>        .
                          .+(   )                       .('  )                                         .+(   )                       .('  )                                                                .+(   )                       .('  )                                                    .+(   )                       .('  )                / |          |                 |>>>          |>>>              |           .
   .')                    (   .  )                    :(      ))                .')                    (   .  )                    :(      ))                                       .')                    (   .  )                    :(      ))                           .')                    (   .  )                    :       ))             /  |          *                 |             |                 *           .
  (_  )                  (   (   ))                   '(    )  ))              (_  )                  (   (   ))                   '(    )  ))                                     (_  )                  (   (   ))                   '(    )  ))                         (_  )                  (   (   ))                   '     )  ))           /   |         / \                *             *                / \          .
                          '. __.'                       ' __.:'                                        '. __.'                       ' __.:'                                                               '. __.'                       ' __.:'                                                   '. __ '                       ' __.:'            /____|        /___\             _/ \           / \_             /___\         .
                                                                                                                                                                                                                                                                                                                                                         |        [   ]            |/   \_________/   \|            [   ]         .
                                                                                                                                                                                                                                                                                                                                                         |        [ I ]            /     \       /     \            [ I ]         .
                                                                                                                                                                                                                                                                                                                                                         |        [   ]_ _ _      /       \     /       \      _ _ _[   ]         .
                                                                                                                                                                                                                                                                                                                            |TTT|                        |        [   ] U U |    {#########}   {#########}    | U U [   ]         .
                                                                                                                                                                                                                                                                                                                            |   |                        |        [   ]====/      \=======/     \=======/      \====[   ]         .
                                                                                                                                                                                                                                                                                                                        |TTT|   |                        |        [   ]    |       |   I |_ _ _ _| I   |       |    [   ]         .
                                                                                                                                                                                                                                                                                                                        |   |   |                        |        [___]    |_ _ _ _|     | U U U |     |_ _ _ _|    [___]         .
                                                                                                                                                                                                                                                                                                                    |TTT|   |   |                        |        \===/  I | U U U |     |=======|     | U U U | I  \===/         .
                                                                                                                                                                                                                                                                                                                    |   |   |   |                        |         \=/     |=======| I   | + W + |   I |=======|     \=/          .
                                                                                                                                                                                                                                                                                                                |TTT|   |   |   |                        |          |  I   |       |     |_______|     |       |   I  |           .
                                                                                                                                                                                                                                                                                                                |   |   |   |   |                        |          |      |       |     |||||||||     |       |      |           .
                       ,@@@                                   ,@@@                                                                               ,@@@                                                                                 ,@@@                                                                  |TTT|   |   |   |   |                        |          |      |       |   I ||vvvvv|| I   |       |      |           .
            ,,,.   ,@@@@@@8@@,                     ,,,.   ,@@@@@@8@@,            .oo8888o.                                            ,,,.   ,@@@@@@8@@,            .oo8888o.       .oo8888o.                              ,,,.   ,@@@@@@8@@,            .oo8888o.                                 ,,,.     |   |   |   |   |   |.oo8888o.               |          |______|-------|_____||     ||_____|-------|______|           .
         ,&%%&%&&%,@@@@@8@@@@@@.                ,&%%&%&&%,@@@@@8@@@@@@.         ,888888888o                                        ,&%%&%&&%,@@@@@8@@@@@@.         ,888888888o     ,888888888o                          ,&%%&%&&%,@@@@@8@@@@@@.         ,888888888o                             ,&%%&%&&|TTT|   |   |   |   |   |888888888o            __|__       /________\     /______||     ||______\     /________\          .
        ,%&8%&&%&&%,@@@8@@@8@@@@8              ,%&8%&&%&&%,@@@8@@@8@@@@8        88888888888'                                      ,%&8%&&%&&%,@@@8@@@8@@@@8        88888888888'    88888888888'                        ,%&8%&&%&&%,@@@8@@@8@@@@8        88888888888'                           ,%&8%&&%&|   |   |   |   |   |   |8888888888'          /     \     |__________|---|________\_____/________|---|__________|         .
TTTTTTTTTTTTTTTTTTTTTTTTTTTTTTTTTTTTTTTTTTTTTTTTTTTTTTTTTTTTTTTTTTTTTTTTTTTTTTTTTTTTTTTTTTTTTTTTTTTTTTTTTTTTTTTTTTTTTTTTTTTTTTTTTTTTTTTTTTTTTTTTTTTTTTTTTTTTTTTTTTTTTTTTTTTTTTTTTTTTTTTTTTTTTTTTTTTTTTTTTTTTTTTTTTTTTTTTTTTTTTTTTTTTTTTTTTTTTTTTTTTTTTTTTTTTTTTTTTTTTTTTTTTTTTTTTTTTTTTTTTTTTTTTTTTTTTTTTTTTTTTTTTTTTTTTTTTTTTTTTTTTTTTTTTTTTTTTTTTTTTTTTTTTTTTTTTTTTTTTTTTTTTTTTTTTTTTTTTTTTTTTTTTTTTTTTTTTTTTTTTTTTTTTTTTTTTTTTT.
TTTTTTTTTTTTTTTTTTTTTTTTTTTTTTTTTTTTTTTTTTTTTTTTTTTTTTTTTTTTTTTTTTTTTTTTTTTTTTTTTTTTTTTTTTTTTTTTTTTTTTTTTTTTTTTTTTTTTTTTTTTTTTTTTTTTTTTTTTTTTTTTTTTTTTTTTTTTTTTTTTTTTTTTTTTTTTTTTTTTTTTTTTTTTTTTTTTTTTTTTTTTTTTTTTTTTTTTTTTTTTTTTTTTTTTTTTTTTTTTTTTTTTTTTTTTTTTTTTTTTTTTTTTTTTTTTTTTTTTTTTTTTTTTTTTTTTTTTTTTTTTTTTTTTTTTTTTTTTTTTTTTTTTTTTTTTTTTTTTTTTTTTTTTTTTTTTTTTTTTTTTTTTTTTTTTTTTTTTTTTTTTTTTTTTTTTTTTTTTTTTTTTTTTTTTTTTTTTT.